1111111111
1000P001C1
1E10000001
1111111111