1111111111
10D00001C1
100P0C01C1
1010E00001
1111111111